111111111111111
1C1000000000001
100000000001101
100000010001P11
100000000000E11
100101010001101
100000000001011
1000000C0000001
111111111111111
