111111111111111
100000000000001
100000000000001
1000000C0000001
100000000000E01
1001010C000C101
1000000P0000101
100000000000001
111111111111111