111111111111111
1C0000000000001
100000000000001
100000010000011
100000000000E11
100101010001101
1000000P0000101
1000000C0000001
111111111111111