1111111111111111111111111111111111
1E0000000000000C00001C000000000001
1010010100100000101001000000010101
1110010010101010001001000000010111
1P00000000C00C000000000000000000C1
1111111111111111111111111111111111