1111111111111111111111111111111
1P0CE11111111111111111111111111
1111111111111111111111111111111
1111111111111111111111111111111
1000011111111111111111111111111
1111111111111111111111111111111
1111111111111111111111111111111
1111111111111111111111111111111
1111111111111111111111111111111
1111111111111111111111111111111
1111111111111111111111111111111
1111111111111111111111111111111
1111111111111111111111111111111
1111111111111111111111111111111