111111111111111111111111111111
1P0CE1111111111111111111111111
111111111111111111111111111111
111111111111111111111111111111
100001111111111111111111111111
111111111111111111111111111111
111111111111111111111111111111
111111111111111111111111111111
111111111111111111111111111111
111111111111111111111111111111
111111111111111111111111111111
111111111111111111111111111111
111111111111111111111111111111
111111111111111111111111111111