11111111111111111111111111
10000000000000000000000001
100001000C0011X00010E0C001
1P000000000000000000000001
11111111111111111111111111
11111111111111111111111111
11111010000100001000011111
11110011110111101111011111
11101011110111101111011111
11111010000100001000011111
11111011110111101111011111
11111011110111101111011111
11111010000100001111011111
11111111111111111111111111
